11111111111111111111111
10000001000000000000001
100E0001000000000000001
100000010000P0000C10001
10000000000000001110001
1000000100C000000000001
10000001000000000000001
11111111111111111111111
