11111111111111111111111
10000000000000000000001
100E0000000000000000001
100000000000P0000C00001
10000000000000000000001
1000000000C000000000001
10000000000000000000001
11111111111111111111111
